R 640 480

NO ./texture              s/redbrick.xpm
SO ./textures/bluestone.xpm
WE ./textures/greystone.xpm
EA ./textures/wood.xpm




S ./textures/barrel.xpm
F 255,248,220
C 135,206,250


       1111111111111111111111111
       1000000000110000000000001
       1011000001110000001000001
       1001000000000000S000000011
111111111011000001110000000000001
100000000011000001110111111111111
11110111111111011100000010001
11110111111111011101010010001
11000000110101011100000010001  1111
10000000000000001100000010001  1001
10000000000000001101010010001  1111
11000001110101011111011110001
11110111 1110101 101111010001
11111111 1111111 111111111111
