R 640 480

NO ./textures/redbrick.xpm
SO ./textures/bluestone.xpm
WE ./textures/greystone.xpm
EA ./textures/wood.xpm

S ./textures/barrel.xpm
F 255,248,220
C 135,206,250


111111111111111111111111
1S0000000000000000000001
100022000101000000000001
100022000000000000200001
100000111110000101010001
100000100010000000000001
100000100010000100010001
100000100010000000000001
100000110110000101010001
100000000000000000000001
100000000000000000000001
100000000000000000000001
100000000000000000000001
100000000000000000000001
100000000000000000000001
100000000000000000000001
111111111000000000200001
110100001000000000000001
110000001000000000000001
110100001000000000000001
110111111000000000000001
110000000000000001111111
111111111000000001111111
111111111111111111111111
