
R 640 480
S ./textures/pillar.xpm
WE ./textures/greystone.xpm
EA ./textures/wood.xpm






















F 255       ,      248    ,       220

SO ./textures/bluestone.xpm
C 135,206,250
NO ./textures/redbrick.xpm



111111111111111111111111
122222222222222222222221
122222222222222222222221
122222222222222222222221
122222222222222222222221
122222222222222222222221
122222222222222222222221
122222222222222222222221
122222222222222222222221
122222222222222222222221
122222222222222222222221
122222222222222222222221
122222222222222222222221
122222222222222222222221
122222222222222222222221
122222222222222222222221
122222222222222222222221
122222222222222222222221
122222222222222222222221
122222222222222222222221
122222222222222222222221
122222222222222222222221
100000001010000000000011
10000S000000000000000001
102000111110000101010001
100000100010000000000001
100000100010000100010001    111111
100000100010000000000001    100001
100000110110000101010001    111111
100000000000000000000001
11111000000000000000000111111
    100000000000000000000001111
11111000000000000000000111111
100000000000000000000001
100000000000000000000001
100000000000000000000001
111111111000000000000001
110100001000000000000001
110000001000000000000001
110100001000000000000001
110111111000000000000001
110000000000000001111111
111111111000000001111111
111111111111111111111111
