NO ./textures/redbrick.xpm
SO ./textures/bluestone.xpm
WE ./textures/greystone.xpm
EA ./textures/wood.xpm

R 640 480

S ./textures/barrel.xpm
F 255,248,220
C 135,206,250

11111111
1111E111
11111111
11110111
11111111
